XXXXXXXXXXXXXXXXXXXXXXXXXXX
X                         X
X                         X
X                         X
X                         X
X                         X
X                         X
X                         X
X                         X
X               LGGR      X
X      P                  X
X     LGGGGR              X
X                         X
X                         X
X                         X
X                         X
X        lgggggggggggr    X
X        dDDDDDDDDDDDb    X
X   LGGGGuuuuuuuuuuuuB    X
X                         X
X                         X
X                         X
X                         X
X                         X
GGGGGGGGGGGGGGGGGGGGGGGGGGG