XXXXXXXXXXXXXXXXXXXXXXXXXXX
X                         X
X                         X
X                         X
X                         X
X                         X
X                         X
X                         X
X                         X
X               XXXX      X
X      P                  X
X     XXXXXX              X
X                         X
X                         X
X                         X
X                         X
X        XXX              X
X                         X
X                         X
X                         X
X                         X
X                         X
X                         X
X                         X
XXXXXXXXXXXXXXXXXXXXXXXXXXX